%%%%%%%%%%%%%%%
%           .P%
%%% %%%.%%.%% %
%.        . . %
%%%%%% %%%o%% %
%...          %
%%%%%%%%%%%%%%%
