%%%%%%%%%%%%%%%%%%%%%
%.          .P      %
%%%.%%%.%%.%% %%%%%%%
%         .         %
%%%%%% %%%% %% %%%%%%
%...                %
%          ...      %
%                   %
%%%%%%%%%%%%%%    %%%
%o              ... %
%%%%%%%%%%%%%%%%%%%%%
